Apple|Olma
Pen|Ruchka
But|Lekin
Car|Avtomobil
Beautiful|Chiroyli
Home|Uy
Dog|It
Food|Ovqat
Happiness|Baxt
Work|Ish
City|Shahar
Dream|Orzu
School|Maktab
Money|Pul
Time|Vaqt
Sunset|Quyosh botishi
Rain|Yomg'ir
Fire|O't
Mountain|Tog'
Road|Yo'l
Green|Yashil
Red|Qizil
Yellow|Sariq
Blue|Ko'k
Friendship|Do'stlilik
Travel|Sayohat
Adventure|Sarguzasht
Hope|Umid
Kindness|Hurmat
Success|Muvaffaqiyat
Health|Salomatlik
Nature|Tabiat
Art|San'at
Knowledge|Bilim
Heart|Dil
Peace|Tinchlik
Joy|Xursandlik
Silence|Sukunat
Rainbow|Esimchilik
Magic|Sehrli
Ocean|Dengiz
Moonlight|Oy yorigi
Laughter|Kulgili
Inspiration|Ilohimlik
Wisdom|Bilimdonlik
Garden|Bog'
Adventure|Sarguzasht
Dance|Raqsga
Courage|Jasorat
Miracle|Mo'jiza
Forgiveness|Kechirasizlik
Serenity|Sukunat
Gratitude|Rahmat
Strength|Kuch
Imagination|Tasavvur
Purpose|Maqsad
Patience|Sabr
Love|Sevgi
Hello|Salom
Apple|Olma
Cat|Mushuk
Book|Kitob
Sun|Quyosh
Tree|Daraxt
Good|Yaxshi
Water|Suv
Love|Sevgi
Friend|Do'st
Music|Musiqi
Time|Vaqt
Happy|Baxtli
Family|Oilaviy
Peace|Tinchlik
Dream|Orzu
Smile|Tabassum
Moon|Oy
Star|Yulduz
Sky|Oyiq
Hope|Umidsizlik
